NO textures/wall_n.xpm
SO textures/wall_s.xpm
WE textures/wall_w.xpm
EA textures/wall_e.xpm

F 220,100,0
C 220,150,0

111111111111111111111111111111111111
100000000000000000000000000000000001
100000000000000000000000000000000001
100000000010000000001000000000000001
100000000010000000000000000001000001
10000000001000000000N000000001000001
100000000010000000000000000000000001
100000000000000000000111000000000001
111111111111111111111111111111111111